"","Team","Summer Olympic Games","Summer Olympic Games","Summer Olympic Games","Summer Olympic Games","Summer Olympic Games"
"1","Afghanistan (AFG)","15","0","0","2","2"
"2","Algeria (ALG)","14","5","4","8","17"
"3","Argentina (ARG)","25","21","26","30","77"
"4","Armenia (ARM)","7","2","8","8","18"
"5","Australasia (ANZ) [ANZ]","2","3","4","5","12"
"6","Australia (AUS) [AUS][Z]","27","164","173","210","547"
"7","Austria (AUT)","28","20","35","41","96"
"8","Azerbaijan (AZE)","7","7","14","28","49"
"9","Bahamas (BAH)","17","8","2","6","16"
"10","Bahrain (BRN)","10","2","2","0","4"
"11","Barbados (BAR) [BAR]","13","0","0","1","1"
"12","Belarus (BLR)","7","13","30","42","85"
"13","Belgium (BEL)","27","44","56","57","157"
"14","Bermuda (BER)","19","1","0","1","2"
"15","Bohemia (BOH) [BOH][Z]","3","0","1","3","4"
"16","Botswana (BOT)","11","0","1","1","2"
"17","Brazil (BRA)","23","37","42","71","150"
"18","British West Indies (BWI) [BWI]","1","0","0","2","2"
"19","Bulgaria (BUL) [H]","21","54","88","82","224"
"20","Burkina Faso (BUR)","10","0","0","1","1"
"21","Burundi (BDI)","7","1","1","0","2"
"22","Cameroon (CMR)","15","3","1","2","6"
"23","Canada (CAN)","27","71","110","145","326"
"24","Chile (CHI) [I]","24","2","7","4","13"
"25","China (CHN) [CHN]","11","263","199","174","636"
"26","Colombia (COL)","20","5","13","16","34"
"27","Costa Rica (CRC)","16","1","1","2","4"
"28","Ivory Coast (CIV) [CIV]","14","1","1","2","4"
"29","Croatia (CRO)","8","14","13","14","41"
"30","Cuba (CUB) [Z]","21","84","69","82","235"
"31","Cyprus (CYP)","11","0","1","0","1"
"32","Czech Republic (CZE) [CZE]","7","19","22","26","67"
"33","Czechoslovakia (TCH) [TCH]","16","49","49","45","143"
"34","Denmark (DEN) [Z]","28","48","78","79","205"
"35","Djibouti (DJI) [B]","9","0","0","1","1"
"36","Dominican Republic (DOM)","15","3","5","4","12"
"37","Ecuador (ECU)","15","3","2","0","5"
"38","Egypt (EGY) [EGY][Z]","23","8","11","19","38"
"39","Eritrea (ERI)","6","0","0","1","1"
"40","Estonia (EST)","13","10","9","17","36"
"41","Ethiopia (ETH)","14","23","12","23","58"
"42","Fiji (FIJ)","15","2","0","1","3"
"43","Finland (FIN)","26","101","85","119","305"
"44","France (FRA) [O][P][Z]","29","223","251","277","751"
"45","Gabon (GAB)","11","0","1","0","1"
"46","Georgia (GEO)","7","10","12","18","40"
"47","Germany (GER) [GER][Z]","17","201","207","247","655"
"48","United Team of Germany (EUA) [EUA]","3","28","54","36","118"
"49","East Germany (GDR) [GDR]","5","153","129","127","409"
"50","West Germany (FRG) [FRG]","5","56","67","81","204"
"51","Ghana (GHA) [GHA]","15","0","1","4","5"
"52","Great Britain (GBR) [GBR][Z]","29","284","318","314","916"
"53","Greece (GRE)","29","35","45","41","121"
"54","Grenada (GRN)","10","1","1","1","3"
"55","Guatemala (GUA)","15","0","1","0","1"
"56","Guyana (GUY) [GUY]","18","0","0","1","1"
"57","Haiti (HAI) [J]","16","0","1","1","2"
"58","Hong Kong (HKG) [HKG]","17","2","3","4","9"
"59","Hungary (HUN)","27","181","154","176","511"
"60","Iceland (ISL)","21","0","2","2","4"
"61","India (IND) [F]","25","10","9","16","35"
"62","Indonesia (INA)","16","8","14","15","37"
"63","Iran (IRI) [K]","17","24","23","29","76"
"64","Iraq (IRQ)","15","0","0","1","1"
"65","Ireland (IRL)","22","11","10","14","35"
"66","Israel (ISR)","17","3","1","9","13"
"67","Italy (ITA) [M][S]","28","217","188","213","618"
"68","Jamaica (JAM) [JAM]","18","26","36","26","88"
"69","Japan (JPN)","23","169","150","178","497"
"70","Jordan (JOR)","11","1","1","1","3"
"71","Kazakhstan (KAZ)","7","14","22","35","71"
"72","Kenya (KEN)","15","35","42","36","113"
"73","Kosovo (KOS)","2","3","0","0","3"
"74","North Korea (PRK)","10","16","16","23","55"
"75","South Korea (KOR)","18","96","91","100","287"
"76","Kuwait (KUW)","13","0","0","3","3"
"77","Kyrgyzstan (KGZ)","7","0","3","4","7"
"78","Latvia (LAT)","12","4","11","6","21"
"79","Lebanon (LBN)","18","0","2","2","4"
"80","Liechtenstein (LIE)","18","0","0","0","0"
"81","Lithuania (LTU)","10","6","7","13","26"
"82","Luxembourg (LUX) [O]","25","2","1","0","3"
"83","Malaysia (MAS) [MAS]","14","0","8","5","13"
"84","Mauritius (MRI)","10","0","0","1","1"
"85","Mexico (MEX)","24","13","24","35","72"
"86","Moldova (MDA)","7","0","2","4","6"
"87","Mongolia (MGL)","14","2","11","17","30"
"88","Montenegro (MNE)","4","0","1","0","1"
"89","Morocco (MAR)","15","7","5","12","24"
"90","Mozambique (MOZ)","11","1","0","1","2"
"91","Namibia (NAM)","8","0","5","0","5"
"92","Netherlands (NED) [Z]","27","95","105","122","322"
"93","Netherlands Antilles (AHO) [AHO][I]","13","0","1","0","1"
"94","New Zealand (NZL) [NZL]","24","53","33","51","137"
"95","Niger (NIG)","13","0","1","1","2"
"96","Nigeria (NGR)","17","3","11","13","27"
"97","North Macedonia (MKD)","7","0","1","1","2"
"98","Norway (NOR) [Q]","27","61","52","50","163"
"99","Pakistan (PAK)","18","3","3","4","10"
"100","Panama (PAN)","18","1","0","2","3"
"101","Paraguay (PAR)","13","0","1","0","1"
"102","Peru (PER) [L]","19","1","3","0","4"
"103","Philippines (PHI)","22","1","5","8","14"
"104","Poland (POL)","22","72","89","137","298"
"105","Portugal (POR)","25","5","9","14","28"
"106","Puerto Rico (PUR)","19","2","2","6","10"
"107","Qatar (QAT)","10","2","2","4","8"
"108","Romania (ROU)","22","90","97","121","308"
"109","Russia (RUS) [RUS]","6","147","126","151","424"
"110","Russian Empire (RU1) [RU1]","3","1","4","3","8"
"111","Soviet Union (URS) [URS]","9","395","319","296","1,010"
"112","Unified Team (EUN) [EUN]","1","45","38","29","112"
"113","Olympic Athletes from Russia (OAR) [OAR]","0","0","0","0","0"
"114","ROC (ROC) [ROC]","1","20","28","23","71"
"115","San Marino (SMR)","15","0","1","2","3"
"116","Saudi Arabia (KSA)","12","0","2","2","4"
"117","Samoa (SAM)","10","0","1","0","1"
"118","Senegal (SEN)","15","0","1","0","1"
"119","Serbia (SRB) [SRB]","5","6","7","11","24"
"120","Serbia and Montenegro (SCG) [YUG/SCG]","3","2","4","3","9"
"121","Singapore (SGP)","17","1","2","2","5"
"122","Slovakia (SVK) [SVK]","7","10","14","8","32"
"123","Slovenia (SLO)","8","8","9","11","28"
"124","South Africa (RSA)","20","27","33","29","89"
"125","Spain (ESP) [Z]","24","48","72","49","169"
"126","Sri Lanka (SRI) [SRI]","18","0","2","0","2"
"127","Sudan (SUD)","13","0","1","0","1"
"128","Suriname (SUR) [E]","13","1","0","1","2"
"129","Sweden (SWE) [Z]","28","147","177","179","503"
"130","Switzerland (SUI)","29","53","79","74","206"
"131","Syria (SYR)","14","1","1","2","4"
"132","Chinese Taipei (TPE) [TPE][TPE2]","15","7","11","18","36"
"133","Tajikistan (TJK)","7","1","1","2","4"
"134","Tanzania (TAN) [TAN]","14","0","2","0","2"
"135","Thailand (THA)","17","10","8","17","35"
"136","Togo (TOG)","11","0","0","1","1"
"137","Tonga (TGA)","10","0","1","0","1"
"138","Trinidad and Tobago (TTO) [TTO]","18","3","5","11","19"
"139","Tunisia (TUN)","15","5","3","7","15"
"140","Turkey (TUR)","23","41","26","36","103"
"141","Turkmenistan (TKM)","7","0","1","0","1"
"142","Uganda (UGA)","16","4","4","3","11"
"143","Ukraine (UKR)","7","35","36","68","139"
"144","United Arab Emirates (UAE)","10","1","0","1","2"
"145","United States (USA) [P][Q][R][Z][F]","28","1,061","830","738","2,629"
"146","Uruguay (URU)","22","2","2","6","10"
"147","Uzbekistan (UZB)","7","10","6","20","36"
"148","Venezuela (VEN)","19","3","7","9","19"
"149","Vietnam (VIE)","16","1","3","1","5"
"150","Virgin Islands (ISV)","13","0","1","0","1"
"151","Yugoslavia (YUG) [YUG to 1992]","16","26","29","28","83"
"152","Zambia (ZAM) [ZAM]","14","0","1","1","2"
"153","Zimbabwe (ZIM) [ZIM]","14","3","4","1","8"
"154","Independent Olympic Athletes (IOA) [IOA]","3","1","0","1","2"
"155","Independent Olympic Participants (IOP) [IOP]","1","0","1","2","3"
"156","Mixed team (ZZX) [ZZX]","3","11","6","8","25"
